%.................................................................................................^
..................................................................................................^
..................................................................................................^
...$..............................................................................................^
..................................................................................................^
..................................<>..............................................................^
........................................................<@@>......................................^
...............................<>....<@>..........&......**.......................................^
.............................................<@@@@@@@>............................................^
...........................<@>..........................&.........................................^
...................#...# ............##..&............<@@@>.................................!.....^
...............<@@@@@@@@>............<@@@@@>................................&..............<@>....^
....1...<@@@>...........................**.......&.............&.........<@@>..&.......<>.........^
....<>.........................................<@@>........<@@@>..............<>..................^
...................................&.........&.......&...........@...@............................?
@@@@@@@@@@@@@@@@@@@@@@@@@@@@@@@@@@@@@@@@@@@@@@@@@@@@@@@@@@@@@@@@@@@@@@@@@@@@@@@@@@@@@@@@@@@@@@@@@@@
