%...............................................................................................^
................................................................................................^
................................................................................................^
.........................................<@@@@>.................................................^
...................................................&............................................^
....................................#&...........<@@@@>.........................................^
.........................&........<@@@@>......................<@@@@>............................^
....................<@@@@@>...................&.........<>.........................!............^
.............................<@@>........<@@@@@>..................................<@@>..........^
..............................................................<@@@@>...&...<@@@@>...............^
................<@@@>......<@>.....................................<@@@@>.......................^
................................................................................................^
.......................&........................................................................^
.................<@@@@@@@@>.....................................................................^
........1$................................###############################..######.......#.#.....?
@@@@@@@@@@@@@@@@@@@@@@@@@@@@@@@@@@@@@@@@@@@@@@@@@@@@@@@@@@@@@@@@@@@@@@@@@@@@@@@@@@@@@@@@@@@@@@@@@