%...................................................................................................
%...................................................................................................
%...................................................................................................
%...$...............................................................................................
%...................................................................................................
%...................................................................................................
%...................................................................................................
%...................................................................................................
%...................................................................................................
%...............................@@@.................................................................
%...................#...# ...........###......................................................!.....
%...............@@@@@@@@@@............@@@@@@@................................................@@@...
%........@@@@@..........................................................@@@@.........@.............
%....@@.........................................@@@@........@@@@@..............@@...................
%................................................................@...@..............................
@@@@@@@@@@@@@@@@@@@@@@@@@@@@@@@@@@@@@@@@@@@@@@@@@@@@@@@@@@@@@@@@@@@@@@@@@@@@@@@@@@@@@@@@@@@@@@@@@@@@