....................................................................................................
....................................................................................................
....................................................................................................
....................................................................................................
....................................................................................................
....................................................................................................
....................................................................................................
....................................................................................................
................................@@@.................................................................
....................##...# ...........###......................................................!....
.................@@@@@@@@@@............@@@@@@@................................................@@@...
.......$..#.................................................................@@@@.........@..........
.......@@@@@.........................................@@@@........@@@@@..............@@..............
.................................................................@...@..............................
@@@@@@@@@@@@@@@@@@@@@@@@@@@@@@@@@@@@@@@@@@@@@@@@@@@@@@@@@@@@@@@@@@@@@@@@@@@@@@@@@@@@@@@@@@@@@@@@@@@@