%...............................................................................................^
................................................................................................^
................................................................................................^
.........................................<@@@@>.................................................^
...................................................&............................................^
....................................#&...........<@@@@>.........................................^
.........................&........<@@@@>......................<@@@@>............................^
....................<@@@@@>................&..-.........<>.........................!............^
.............................<@@>........<@@@@@>..................................<@@>..........^
.................-............................................<@@@@>...&...<@@@@>...............^
................<@@@>......<@>.....................................<@@@@>.......................^
................................................................................................^
.......................&........................................................................^
.................<@@@@@@@@>.....................................................................^
........1$................................###############################..######.......#.#.....?
@@@@@@@@@@@@@@@@@@@@@@@@@@@@@@@@@@@@@@@@@@@@@@@@@@@@@@@@@@@@@@@@@@@@@@@@@@@@@@@@@@@@@@@@@@@@@@@@@
.................................................................................................
.................................................................................................
.................................................................................................
.................................................................................................
.................................................................................................
.................................................................................................
.................................................................................................
-................................................................................................
