%..................................................................................................
...................................................................................................
...................................................................................................
...$.........................................................................................
...................................................................................................
..................................@@...............................................................
...................................................................................................
...............................@@....@@@..........&..............................................
..............................................@@@@@@@@@............................................
............................@@@..........................&.........................................
...................#...# ...........###....&..........@@@@@...................................!...
...............@@@@@@@@@@............@@@@@@@................................&................@@@...
........@@@@@....................................&.............&.........@@@@..&.......@...........
....@@.........................................@@@@........@@@@@..............@@...................
.......................&...........&.........&.......&...........@...@............................?
@@@@@@@@@@@@@@@@@@@@@@@@@@@@@@@@@@@@@@@@@@@@@@@@@@@@@@@@@@@@@@@@@@@@@@@@@@@@@@@@@@@@@@@@@@@@@@@@@@@
