$...................................................................................................
....................................................................................................
....................................................................................................
....................................................................................................
....................................................................................................
....................................................................................................
....................................................................................................
....................................................................................................
....................................................................................................
................................@@@.................................................................
....................##...# ...........###......................................................!....
.................@@@@@@@@@@............@@@@@@@................................................@@@...
..........@@@@@..........................................................@@@@.........@...............
.....@@.........................................@@@@........@@@@@..............@@...................
.................................................................@...@..............................
@@@@@@@@@@@@@@@@@@@@@@@@@@@@@@@@@@@@@@@@@@@@@@@@@@@@@@@@@@@@@@@@@@@@@@@@@@@@@@@@@@@@@@@@@@@@@@@@@@@@